ου	ος
ο	ος
ε	ος
η	ος	ης
ης	ος
οι	ος
ων	ος	ης	ονας
ους	ος	ης
ες	ος	ης
α	ος	ης	
ας	ος	ης
ού	ός	άς
εις	ης
ό	ός
έ	ός
ιά	ός	ύς	ής
ιάς	ός	ύς	ής
οί	ός
ών	ός	ής
ούς	ός	άς	ής
ές	ός	ής
ά	ός	άς
ιού	ύς	ής
ύ	ύς
ιοί	ύς	ής
είς	ύς	ής
ιών	ύς	ής
ιές	ύς	ής
έος	ύς
εία	ύς
είας	ύς
έων	ύς
είες	ύς
έα	ύς
ή	ής
ί	ής
ιούς	ής
ικο	ης
ικου	ης
ηδες	ης
ηδων	ης
ικα 	ης
ικων	ης
άδικο	άς
άδικου	άς
άδες	άς
άδων	άς
ούδες	άς
ούδων	άς
άδικα	άς
άδικων	άς
οντος	ων
οντα	ων
ουσα	ων
ουσας	ων
ον	ων	ονας
οντες	ων
όντων	ων	ών
ουσες	ων
ουσών	ων	ών
όντος	ών
όντα	ών
ούσα	ών
ούσας	ών
όν	ών
όντος	ών
όντες	ών
ούσες	ών
ονος	ων	ονας
ονα	ων	ονας
ονες	ων	ονας
όνων	ων	ονας
ονα	ων	ονας
έντος	είς
έντα	είς
είσα	είς
είσας	είς
είσης	είς
έν	είς
έντες	είς
έντων	είς
είσες	είς
εισών	είς
αντος	ας
αντα	ας
ασα	ας
ασας	ας
ασης	ας
αν	ας
αντες	ας
άντων	ας
ασες	ας
ασών	ας
αντα	ας





