πολλού  πολύς
πολύ    πολύς
πολλή   πολύς
πολλής  πολύς
πολλοί  πολύς
πολλών  πολύς
πολλούς πολύς
πολλές  πολύς
πολλά   πολύς
του     ο
τον     ο
η       ο
της     ο
τη      ο
την     ο
το      ο
οι      ο
των     ο
τους    ο
τις     ο
τα      ο
αυτού	αυτός	
αυτόν	αυτός
αυτή	αυτός
αυτής	αυτός
αυτήν	αυτός
αυτό	αυτός
αυτοί	αυτός
αυτών	αυτός
αυτούς	αυτός
αυτές	αυτός
αυτά	αυτός
εκείνου	εκείνος
εκείνο	εκείνος
εκείνη	εκείνος
εκείνης	εκείνος
εκείνην	εκείνος
εκείνοι	εκείνος
εκείνων	εκείνος
εκείνους	εκείνος
εκείνες	εκείνος
εκείνα	εκείνος
τέτοιου	τέτοιος
τέτοιο	τέτοιος
τέτοια	τέτοιος
τέτοιας	τέτοιος
τέτοιοι	τέτοιος
τέτοιων	τέτοιος
τέτοιους	τέτοιος
τέτοιες	τέτοιος
τέτοια	τέτοιος
τόσου	τόσος
τόσο	τόσος
τόση	τόσος
τόσης	τόσος
τόση	τόσος
τόσοι	τόσος
τόσων	τόσος
τόσους	τόσος
τόσες	τόσος
τόσα	τόσος
εμένα	εγώ
μένα	εγώ
μου	εγώ
εσύ	εγώ
εσένα	εγώ
σένα	εγώ
σου	εγώ
εμείς	εγώ
εμάς	εγώ
μας	εγώ
εσείς	εγώ
εσάς	εγώ
σας	εγώ
όποιου	όποιος
όποιο	όποιος
όποιον	όποιος
όποιας	όποιος
όποια	όποιος
όποιο	όποιος
όποιοι	όποιος
όποιων	όποιος
όποιους	όποιος
όποιες	όποιος
όποια	όποιος
οποίου	οποίος
οποίο	οποίος
οποία	οποίος
οποίας	οποίος
οποίοι	οποίος
οποίων	οποίος
οποίους	οποίος
οποίες	οποίος
οποία	οποίος
όσου	όσος
όσο	όσος
όσης	όσος
όση	όσος
όσοι	όσος
όσων	όσος
όσους	όσος
όσες	όσος
όσα	όσος
ποιου	ποιος
ποιανού	ποιος  
τίνος	ποιος
ποιο	ποιος
ποια	ποιος
ποιας	ποιος
ποιανής	ποιος
ποιοι	ποιος
ποιων	ποιος
ποιανών	ποιος
τίνων	ποιος
ποιους	ποιος
ποιες	ποιος
ποια	ποιος
πόσου	πόσος
πόσο	πόσος
πόσης	πόσος
πόση	πόσος
πόσοι	πόσος
πόσων	πόσος
πόσους	πόσος
πόσες	πόσος
πόσα	πόσος
ενός	ένας
έναν	ένας
μία	ένας
μια	ένας
μίας	ένας
μιας	ένας
μία	ένας
μια	ένας
ένα	ένας
κανενός	κανένας
κανέναν	κανένας
καμία	κανένας
καμιά	κανένας
καμίας	κανένας
καμιάς	κανένας
καμία	κανένας
καμιά	κανένας
κανένα	κανένας
κάποιου	κάποιος
κάποιο	κάποιος
κάποιας	κάποιος
κάποια	κάποιος
κάποιοι	κάποιος
κάποιων	κάποιος
κάποιους	κάποιος
κάποιες	κάποιος
κάποια	κάποιος
καθενός	καθένας
καθέναν	καθένας
καθεμία	καθένας
καθεμιά	καθένας
καθεμίας	καθένας
καθεμιάς	καθένας
καθεμία	καθένας
καθεμιά	καθένας
καθένα	καθένας
άλλου	άλλος
αλλουνού	άλλος
άλλο	άλλος
άλλης	άλλος
αλληνής	άλλος
άλλη	άλλος
άλλου	άλλος
αλλουνού	άλλος
άλλο	άλλος
άλλοι	άλλος
άλλων	άλλος
αλλονών	άλλος
άλλους	άλλος
αλλουνούς	άλλος
άλλες	άλλος
άλλα	άλλος