εις	ω	άμαι	ούμαι	ίσκω	αίνω
ει	ω	άμαι	ούμαι	ίσκω	αίνω
ουμε	ω	άμαι	ούμαι	ίσκω	αίνω
ομε	ω	άμαι	ούμαι	ίσκω	αίνω
ετε	ω	άμαι	ούμαι	ίσκω	αίνω
ουν	ω	άμαι	ούμαι	ίσκω	αίνω	
ουνε	ω	άμαι	ούμαι	ίσκω	αίνω
ε	ω	ομαι
ονταν	ομαι
ω	ίσκω	ομαι	αίνω
ομαι	ω	ομαι
εσαι	ω	ομαι
εται	ω	ομαι
όμαστε	ω	ομαι
εστε	ω	ομαι
οσαστε	ω	ομαι
ονται	ω	ομαι
γομαι	ω	ομαι
γεσαι	ω	ομαι
γεται	ω	ομαι
γόμαστε	ω	ομαι
γεστε	ω	ομαι
γοσαστε	ω	ομαι
γονται	ω	ομαι
ου	ω
έσει	ώ
εστε	ω	ομαι
θηκα	ω	νω
θηκες	ω	νω
θηκε	ω	νω
θηκαμε	ω	νω
θηκατε	ω	νω
θηκαν	ω	νω
θηκανε	ω	νω
ηκα	ω	ομαι
ηκε	ω	ομαι
ηκες	ω	ομαι
ηκαμε	ω	ομαι
ηκατε	ω	ομαι
ηκαν	ω	ομαι
ηκανε	ω	ομαι
όστηκα	όζω
όστηκες	όζω
όστηκε	όζω
οστήκαμε	όζω
οστήκατε	όζω
οστήκανε	όζω
όστηκαν	όζω
ήκα	ίσκω	αίνω
ήκε	ίσκω	αίνω
ήκες	ίσκω	αίνω
ήκαμε	ίσκω	αίνω
ήκατε	ίσκω	αίνω
ήκαν	ίσκω	αίνω
ήκανε	ίσκω	αίνω
α	ω
ες	ω
ε	ω
αμε	ω
ατε	ω
αν	ω
ανε	ω
σα	νω	φτω
σες	νω	φτω
σε	νω	φτω
σαμε	νω	φτω
σατε	νω	φτω
σαν	νω	φτω
σανε	νω	φτω	
σω	νω	φτω
σεις	νω	φτω
σει	νω	φτω
σουμε	νω	φτω
σετε	νω	φτω
σουν	νω	φτω
σουνε	νω	φτω
ώσει	ίδω	ίνω
ίσω	ίζω
ίσεις	ίζω
ίσει	ίζω
ίσουμε	ίζω
ίσατε	ίζω
ίσετε	ίζω
ίστε	ίζω
ίσουν	ίζω
ίσουνε	ίζω
ήστε	ώ	άω
οντας	ω
άς	ώ	άω
ά	ώ	άω
άει	ώ	άω
άμε	ώ	άω
ούμε	ώ	άω	άμαι	ούμαι	ίσκω
άτε	ώ	άω
ούν	ώ	άω
άνε	ώ	άω
ούνε	ώ	άω
ώντας	ώ	άω	
ούσα 	ώ	άω	ω
ούσες	ώ	άω	ω
ούσε	ώ	άω	ω
ούσαμε	ώ	άω	ω
ούσατε	ώ	άω	ω
ούσαν	ώ	άω	ω
ούσανε	ώ	άω	ω
ήσω	ώ	άω	ω
ήσεις	ώ	άω	ω
ήσει	ώ	άω	ω
ήσουμε	ώ	άω	ω
ήσετε	ώ	άω	ω
ήσουν	ώ	άω	ω
ήσουνε	ώ	άω	ω
άσω	ώ	άω	άζω	νάω	νω
άσεις	ώ	άω	άζω	νάω	νω
άσει	ώ	άω	άζω	νάω	νω
άσουμε	ώ	άω	άζω	νάω	νω
άσετε	ώ	άω	άζω	νάω	νω
άσουν	ώ	άω	άζω	νάω	νω
άσουνε	ώ	άω	άζω	νάω	νω
ησα	ώ	άω
ησες	ώ	άω
ησε	ώ	άω
ήσαμε	ώ	άω
ήσατε	ώ	άω
ήσαν	ώ	άω
ήσανε	ώ	άω
ιέμαι	ώ	άω  	ιέμαι
ιέσαι	ώ	άω  	ιέμαι
ιέται	ώ	άω  	ιέμαι
ιόμαστε	ώ	άω  	ιέμαι
ιέστε	ώ	άω  	ιέμαι
ιόσαστε	ώ	άω  	ιέμαι
ιούνται	ώ	άω  	ιέμαι
ιόνται	ώ	άω  	ιέμαι
ιόμουν	ώ	άω  	ιέμαι
ιόμουνα	ώ	άω  	ιέμαι
ιόσουν	ώ	άω  	ιέμαι
ιόσουνα	ώ	άω  	ιέμαι
ιόταν	ώ	άω  	ιέμαι
ιότανε	ώ	άω  	ιέμαι
ίζομαι	ίζω
ίζεσαι	ίζω
ίζεται	ίζω
ιζόμαστε	ίζω	
ίζεστε	ίζω
ιζόσαστε	ίζω	
ίζονται	ίζω
ιστώ	ίζω
ιστείς	ίζω
ιστεί	ίζω
ιστούμε	ίζω
ιστείτε	ίζω
ιστούν	ίζω
ιστούνε	ίζω
ιόμασταν	ώ	άω	ιέμαι  
ιόσασταν	ώ	άω	ιέμαι     
ιούνταν		ώ	άω	ιέμαι
ιούντανε	ώ	άω	ιέμαι    
ιόντουσαν	ώ	άω	ιέμαι
ήθηκα	ώ	άω	άμαι	ούμαι
ήθηκες	ώ	άω	άμαι	ούμαι
ήθηκε	ώ	άω	άμαι	ούμαι
ηθήκαμε	ώ	άω	άμαι	ούμαι
ηθήκατε	ώ	άω	άμαι	ούμαι
ήθηκαν	ώ	άω	άμαι	ούμαι
ηθήκανε	ώ	άω	άμαι	ούμαι
ηθώ	ώ	άω	άμαι	ούμαι
ηθείς	ώ	άω	άμαι	ούμαι
ηθεί	ώ	άω	άμαι	ούμαι
ηθούμε	ώ	άω	άμαι	ούμαι
ηθείτε	ώ	άω	άμαι	ούμαι	ίζω
υθείται	ύνω
ηθούν	ώ	άω	άμαι	ούμαι
ηθούνε	ώ	άω	άμαι	ούμαι
ήσου	ώ	άω
είς	ώ
εί	ώ
είτε	ώ	άμαι	ούμαι	ίσκω
ώντας	ώ
ούμαι	ώ	
είσαι	ώ	ούμαι
είται	ώ	ούμαι
ούμαστε	ώ	ούμαι
είστε	ώ	ούμαι
ούνται	ώ	ούμαι
ούμουν	ώ
ούμουνα	ώ
ούσουν	ώ
ούσουνα	ώ
ούνταν	ώ
ούντανε	ώ
ούμασταν	ώ	 
ούσασταν	ώ 
ιόντανε	ώ
άσαι	άμαι	ούμαι	ω
άται	άμαι	ούμαι	ω
όμαστε	άμαι	ούμαι	ω
ούμαστε	άμαι	ούμαι	ω
όσαστε	άμαι	ούμαι	ω
άστε	άμαι	ούμαι	ω
ούνται	άμαι	ούμαι	ω
ουνα	άμαι	ούμαι	ω
όμουν	άμαι	ούμαι	ω
όμουνα	άμαι	ούμαι	ω
όσουν	άμαι	ούμαι	ω
όσουνα	άμαι	ούμαι	ω
όταν	άμαι	ούμαι	ω
ότανε	άμαι	ούμαι	ω
όμασταν	άμαι	ούμαι	ω
όμαστε	άμαι	ούμαι	ω
όσασταν	άμαι	ούμαι	ω
όσαστε	άμαι	ούμαι	ω
ούνταν	άμαι	ούμαι	ω
ούντανε	άμαι	ούμαι	ω
όντουσαν	άμαι	ούμαι	ω
έρχεσαι	έρχομαι
έρχεται	έρχομαι
ερχόμαστε	έρχομαι
έρχεστε	έρχομαι
έρχονται	έρχομαι
ερχόμουν	έρχομαι
ερχόσουν	έρχομαι
ερχόταν	έρχομαι
ερχόμαστε	έρχομαι
έρχόσαστε	έρχομαι
έρχονταν	έρχομαι
έλθω	έρχομαι
έλθεις	έρχομαι
έλθει	έρχομαι
έλθουμε	έρχομαι
έλθετε	έρχομαι
έλθουν	έρχομαι
ήλθα	έρχομαι
ήλθες	έρχομαι
ήλθε	έρχομαι
ήλθαμε	έρχομαι
ήλθατε	έρχομαι
ήλθαν	έρχομαι
ξω	ζω	γω	χνω	σσω
ξεις	ζω	γω	χνω	σσω
ξει	ζω	γω	χνω	σσω
ξουμε	ζω	γω	χνω	σσω
ξομε	ζω	γω	χνω	σσω
ξετε	ζω	γω	χνω	σσω
ξουν	ζω	γω	χνω	σσω
ξουνε	ζω	γω	χνω	σσω
ήρα	αίρνω
ήρες	αίρνω
ήρε	αίρνω
ήραμε	αίρνω
ήρατε	αίρνω
ήραν	αίρνω
ήρανε	αίρνω
άρα	αίρνω
άρεις	αίρνω
άρει	αίρνω
άρουμε	αίρνω
άρετε	αίρνω
άρουν	αίρνω
άρουνε	αίρνω
σσω	ζω
σσεις	ζω
σσει	ζω
σσουμε	ζω
σσομε	ζω
σσετε	ζω
σσουν	ζω	
σσουνε	ζω
ψω	βω	φω	πτω
ψε	βω	φω	πτω
ψεις	βω	φω	πτω
ψει	βω	φω	πτω
ψουμε	βω	φω	πτω
ψομε	βω	φω	πτω
ψετε	βω	φω	πτω
ψουν	βω	φω	πτω
ψουνε	βω	φω	πτω
έψω	εύω
έψεις	εύω
έψει	εύω
έψουμε	εύω
έψομε	εύω
έψετε	εύω
έψουν	εύω	
έψουνε	εύω
ύγω	εύγω
ύγεις	εύγω
ύγει	εύγω
ύγουμε	εύγω
ύγετε	εύγω
ύγουν	εύγω
ύγουνε	εύγω
ύγε	εύγω
λω	ζω
λεις	ζω
λει	ζω
λουμε	ζω
λομε	ζω
λετε	ζω
λουν	ζω	
λουνε	ζω
λαμε	ζω
λατε	ζω
άστηκα	άω	ώ	άζομαι
άστηκες	άω	ώ	άζομαι
άστηκε	άω	ώ	άζομαι
αστήκαμε	άω	ώ	άζομαι
αστήκατε	άω	ώ	άζομαι
αστήκανε	άω	ώ	άζομαι
άστηκαν	έπω
άπηκα	έπω
άπηκες	έπω
άπηκε	έπω
απήκαμε	έπω
απήκατε	έπω
απήκανε	έπω
άπηκαν	έπω
είλω	έλνω
είλεις	έλνω
είλει	έλνω
είλουμε	έλνω
είλετε	έλνω
είλουν	έλνω
είλαμε	έλνω
είλατε	έλνω
είνω	ένω
είνεις	ένω
είνει	ένω
είνουμε	ένω
είνετε	ένω
είνουν	ένω
είναμε	ένω
είνατε	ένω
ειστώ	είθω
ειστείς	είθω
ειστεί	είθω
ειστούμε	είθω
ειστείτε	είθω
ειστούν	είθω
ειστήκαμε	είθω
ειστήκατε	είθω