είχα	έχω
έχεις	έχω
έχε	έχω
είχες	έχω
έχει	έχω
είχε	έχω
έχουμε	έχω
είχαμε	έχω
έχοντας	έχω
είχατε	έχω
έχετε 	έχω
έχουν	έχω
έχουνε 	έχω
είχαν	έχω
είχανε	έχω
είμαι 	είμαι
ήμουν	είμαι
ήμουνα	είμαι
είσαι	είμαι
ήσουν	είμαι
ήσουνα	είμαι
είναι	είμαι
ήταν	είμαι
ήτανε	είμαι
είμαστε	είμαι
όντας	είμαι
ήμασταν	είμαι
ήμαστε	είμαι
είσαστε	είμαι
ήσασταν	είμαι
ήσαστε	είμαι
λες	λέω
λέει	λέω
λέμε	λέω
λέτε	λέω
λεν	λέω
λένε	λέω
λέγε	λέω
λέγετε	λέω
έλεγα   λέω
έλεγες  λέω
έλεγε   λέω
λέγαμε  λέω
λέγατε  λέω
έλεγαν  λέω
λέγανε  λέω
λέγανε  λέω
είπα    λέω
είπες   λέω
είπε	λέω
είπαμε  λέω
είπατε  λέω
είπαν   λέω
είπανε  λέω
πω	λέω
πεις	λέω
πει     λέω
πούμε	λέω
πείτε	λέω
πουν	λέω
πούνε	λέω
ακούς	ακούω
ακούει	ακούω
ακούμε	ακούω
ακούτε	ακούω
ακούν	ακούω
ακούνε	ακούω
άκου	ακούω
άκουγε	ακούω
ακούτε	ακούω
πρέπει	πρέπει
πρόκειται	πρόκειται
μέλλει	μέλλει
έρχεσαι	έρχομαι
έρχεται	έρχομαι
ερχόμαστε	έρχομαι
έρχεστε	έρχομαι
έρχονται	έρχομαι
ερχόμουν	έρχομαι
ερχόσουν	έρχομαι
ερχόταν	έρχομαι
ερχόμαστε	έρχομαι
έρχόσαστε	έρχομαι
έρχονταν	έρχομαι
έρθω	έρχομαι
έρθεις	έρχομαι
έρθει	έρχομαι
έρθουμε	έρχομαι
έρθετε	έρχομαι
έρθουν	έρχομαι
ήρθα	έρχομαι
ήρθες	έρχομαι
ήρθε	έρχομαι
ήρθαμε	έρχομαι
ήρθατε	έρχομαι
ήρθαν	έρχομαι
ήλθα	έρχομαι
ήλθες	έρχομαι
ήλθε	έρχομαι
ήλθαμε	έρχομαι
ήλθατε	έρχομαι
ήλθαν	έρχομαι
έλα	έρχομαι
ελάτε	έρχομαι
δω	βλέπω
δεις	βλέπω
δει	βλέπω
δούμε	βλέπω
δείτε	βλέπω
δουν	βλέπω
δούνε	βλέπω
δες	βλέπω
δείτε	βλέπω
είδα	βλέπω
είδες	βλέπω
είδε	βλέπω
είδαμε	βλέπω
είδατε	βλέπω
είδαν	βλέπω
είδανε	βλέπω
φάω	τρώω
φάγω	τρώω
φάς	τρώω
φάει	τρώω
φάγει	τρώω
φάμε	τρώω
φάτε	τρώω
φάουν	τρώω
φάγουν	τρώω
έφαγα	τρώω
έφαγες	τρώω
έφαγε	τρώω
φάγαμε	τρώω
φάγατε	τρώω
έφαγαν	τρώω
φάγε	τρώω
να	να